NO ./path_to_the_north_texture.xpm


SO ./path_to_the_south_texture.xpm


WE ./path_to_the_west_texture.xpm


EA ./path_to_the_east_texture.xpm


F 220,140,0



C 225,30,0



        1111111111111111111111111
        1000000000110000000000001
        1011000001110000000000001
        100100000000000000000000011
111111111011000001110000000000001
100000000011000001110111111111111
1111111111111101111111111111
             101
11111111111111011111111111111
10000000000000001100000010001
10000000000000001101010010001
1100000111010101111101111000111
11110111 1110101 1011101S001
11111111 1111111 111111111111
