NO ./path_to_the_north_texture.xpm


SO ./path_to_the_south_texture.xpm


WE ./path_to_the_west_texture.xpm


EA ./path_to_the_east_texture.xpm


F 185, 180, 171



C 135,206,250



        1111111111111111111111111
        1000000000110000000000101
        10110000011100000000N0101
        1001000000000000000000001
111111111011000001110000000000001
100000000011000001110100111111111
1111111111111121111111001111
             101     1001
11111111111111011111110011111
10000000000000001100000000001
10000000000000001101010000001
1100000111010101111101111121111
11110111 1110101 10111010001
11111111 1111111 111111111111
