NO ./path_to_the_north_texture.xpm


SO ./path_to_the_south_texture.xpm


WE ./path_to_the_west_texture.xpm


EA ./path_to_the_east_texture.xpm


F 0,64,128



C 135,206,250

111111
100101
101001
1100N1
111111